#############################################,
#                                           #,
#       |%|%|%|%|%|%|             * .%%%%   #,
#... ...|%|                    % % ..%  %   #,
#... ...|%|....                %  %..%  %   #,
#... ...|%| .....                  ........ #,
#... ...                                    #,
#       |%|  *                              #,      
#.. ... |%|.......  .      ...... @         #,    
# ......|%|   ......        .               #,
#                                           #,
#..    ... ....@......   ........|&|        #,
#  ........                                 #,
# ...%%%%...  *                   @         #,
#                                           #,
#    %%%%    *                 ..|$| |$|    #,
#    ..... .                   ..|$|  |$|   #,
# ..........               *   ..|$|  |$|   #,
# .....@....            *   |$|..|$| |$|    #,
#############################################